00000000000
000000d0j0g
000000k0e00
0kdf0000000
00l00000f00
0l000000000
0e0000000a0
0c00g00j000
00000c0i000
a000000b00i
h0000000h0b

0000000000h
00g0000cd00
00a00000000
00000000000
0g000000e00
0d00fc00b00
00000000000
00000000000
0fb00000000
000000ie000
aih00000000

00000000000
00000e00000
0bi00000cai
000b0000d00
0gj0000j0h0
0d000a00000
0f0000e0000
0000000c000
00000000000
000fg0h0000
00000000000

0000d000000
0j00000hlk0
0h000000000
00000000i00
0eb00000000
000g0eli000
000c00bf0a0
d0000000000
0000jak0000
0c000000000
0gf00000000

0000000eaj0
00000c00000
b0000000000
000d0000000
000i00000a0
0bh00hi00e0
000000000d0
00000f0ljk0
00fg0g00000
00000l0k000
00000c00000

00000000000
0je00g00000
00000000h00
000000chk00
0j000c0d000
0000000i0d0
ke0000000a0
f0000000000
00bib0a0000
000000l00l0
f000g000000

g0000000h00
00c00000000
00000000e00
000fb000000
0000000c000
00000000000
000e000ih00
00000d00000
000ag000000
0a00000i0f0
000d000b000

k000000000k
0h0jl000000
000ge0il0f0
000000a000e
000c00b0000
00000000000
000000b0000
00000000000
0000000ia00
00g00000000
hjd0dcf0000

ke00000000f
0b000j00000
00kc00d0j00
ih0000000e0
000h00000f0
a000i00000l
00000000a00
00000g00000
00cg000b000
00000000000
00000d0000l

hde00000000
000000000d0
0c0f0000000
000a0g00000
i000000bgfe
00000b00000
00000000000
c0h00000i00
00000000000
00000000000
a0000000000

000jk00000k
0h000000000
0000000000j
00il000fl00
000a00000e0
00000a0f00b
00000000000
0000hi00000
0g000d0e0d0
0c0c000b000
0000000000g

b0000000000
00l0000ge0f
b00clc00g00
00000a0f0d0
00i00d000a0
00h00000000
00000000000
000k00000j0
0000000h0k0
0i0000000j0
000e0000000

cei00j0j000
000000000f0
00c00000000
e000i00g000
k0000000000
0d0l0d0afg0
000000000b0
00k000b00h0
00a00h000l0
00000000000
00000000000

a0000000000
00000g0eb00
00g00000d00
0000f00d000
000h000b0j0
00000000e0c
00000000000
00000000000
000000h00i0
0c0000000f0
0ak000kij00

h0000000000
000c00000d0
000adf00bf0
0000ceg0000
00000000b00
0g000000000
00000000000
k00a00i0000
000000000k0
0he00000000
0000000ij0j

0d000000000
0000000e00f
00h0b000h00
0fg00000000
00000000000
00d00000000
0j000ei00b0
000000000g0
000000i00c0
0c000000000
0ja0000000a

l00000mb000
00000000am0
00ag00g000b
00000000i00
0000000kf00
00j000j0c00
0000c000d00
000000i0000
he000000f00
000elk000d0
00000h00000

0000000000b
0000d0c0g00
00h0h000f00
00000000000
00000e00f00
000000g0000
000000e00a0
000a00c0000
0000000000d
000000000b0
00000000000

00000000000
000000l00l0
0000f00i000
0e000b00ei0
0000d00f000
j0c00000j00
0000g000000
0cgh0000000
0ak0k0000d0
000000ah0b0
00000000000

i00000000hd
c000j00fe00
0000f0h0000
0i000000000
0000cb00000
0000000g000
00000000000
0e000000000
00000d0a000
ab00000gj00
00000000000

00000000a00
000d00000b0
00c00j00cj0
00000000000
000g0fa0000
00f00000000
000hk000000
00000000e00
0d00g00000k
0h000000e0b
00000000i0i

0000000000j
00000ba0j0f
0000000if0a
000l0000000
000g0000000
0000000le00
00000000g00
00h0000b000
0000000c0h0
0k000ik00d0
000000c00ed

00000000000
000000000g0
00e000b0000
00000000000
00000000ag0
00f000000b0
000e00000f0
0000000a000
00c00000000
0000d0d0000
00000000c00

000h00000b0
0i000dga0h0
00f00g0000b
00000d00000
00000c0j000
00000000000
00c0000e000
00000ja0000
00000e00000
0i0000000f0
00000000000

0000000e000
0g000000a00
000fk0b0j00
00c00000000
0000k000000
0000f000j00
i000g0b0000
0000h0de000
0c000000h00
00000i00a00
d0000000000

00000000000
00000000000
00000000c00
000e0000000
00000000000
000000c0e00
0hj00f00f00
000i000b000
00ag0gda00h
00d0000000i
j000000000b

000000000ea
0j00f0000c0
0bd00f00000
d00i000000h
g000000e000
i000000k000
j00000000ah
000g0000000
c0000000000
00000000bk0
00000000000

00000000000
0j000000000
000gid000b0
00000f00000
00000k00fkc
dj000000000
b00ga0l00h0
a00000000c0
00000m0l0he
0i0000000m0
00000000e00

0000000000c
0000000000i
000000000be
0000ad00000
00g0f0g00b0
00fa00h0ie0
0k000000d00
000000000j0
00h0000kj00
0000000000c
00000000000

0bf00000000
0000d00dajk
0000h0j0000
00k0f000000
00000g00000
00l00c0i000
00e0c0h0000
000g0000000
000e0000000
0li000a0000
0000b000000