a0000c000c
000j000000
00jb000000
0feh00e000
0l0000h0b0
00000000k0
00a00g000f
dk00000000
0i0000l0g0
0d00i00000

0000000h00
0d00gf00b0
000ce00000
0000000000
0dg0000e00
00000b0000
0000000000
00000c0000
00a00000f0
a0000000h0

000000d000
0000g0b0b0
000000ad00
000h000c00
00000e0000
f0000ahf00
g000000000
ce00000000
0000000000
0000000000

i000a0000b
0000000000
ch0e00f000
00cdg00000
0000000000
0000000000
000000f000
0dg0000000
0e00ih0000
000000ab00

00000000eb
hf000g00a0
0000000b00
0j0e00d000
000c000000
00000000a0
0000c0h0g0
0000000fi0
00000j0000
0000000id0

0000000000
0c000c00ib
000ji0000k
0ab00000hg
0ek0000000
000j00g000
0000000000
a000000000
fd0000dhe0
000000f000

00000f0000
0000000000
0ad000c000
0000000000
00000db0bf
000000000e
00kih0h00g
000000iej0
0c00000000
000000akjg

a000000000
0000000000
00000000i0
00g000gba0
00e000000h
i000000000
f00000ed00
000cd00000
0b000000c0
000fh00000

00000ach00
0fi0000000
000fd00000
00ab000000
0000000000
0e0geb0000
0000000000
0gd0000000
ci00000000
00000000h0

0000bc0000
0g00ab0000
0000000a00
i000000000
jg00000000
00j0000000
fd00000000
000h0e0e00
0000000h00
f0000di00c

000j000000
000c000000
00k0000d00
0000000h00
00000edk00
0000000g0g
000e0a00bi
000h00fb00
000c000aif
000j000000

0000000000
0c00000f0a
00ie0b0c00
0000000000
0000000h00
0ieb000000
00000000d0
00h0000000
000g0ag000
00000d00f0

0000000000
0e000bcgi0
000d000000
00000h0000
f0000a0g00
0000000000
00000ad000
0be0c00h00
000000i000
f000000000

0000000000
000ce000a0
0cbd00g000
0b000j0000
00j00g0000
0000000000
0k00h00ea0
0000000000
0i00k00000
00hif000fd

b00000000b
ge00000000
0000000000
0i00000000
00000gd0i0
0000h000a0
0000000000
0000d00hcf
0a00e00000
00000000cf

000000ga00
00000jb000
00bh000h00
0000000000
00000000e0
gf00000a00
e000000000
i00000c000
0d00f00jc0
di00000000

0000000000
000d0a00g0
000c000000
000fb000e0
00000000a0
0000000dh0
0000cfb000
00g0000000
eh00000000
0000000000

0000000000
0b000ji000
00000hg000
00j0a0f0i0
0000h00000
0g0d000000
0k000f00d0
0000ae0000
k0c0000000
b000000ce0

0000000h0g
0fc00f000d
00000bd0g0
00000000a0
0000b00e00
0000000h00
000c00e000
0000000000
0a00000000
0000000000

000bd0i000
bed00000g0
00j0000000
000i0000a0
0j0ec00000
000000h000
h0000000f0
0g000a0000
000f000000
c000000000

g000000j0a
f00k000000
000d000cj0
00000d0000
00i0b0000a
00000ce00k
000000000b
0000000eh0
000fg000i0
h000000000

ag00ef0000
0d000bd000
00000i0i00
0000bh0000
0000000000
000gc0000f
00j000e000
00c0j0h0k0
000000k000
0a00000000

00000k0000
g00000ge00
00j00ik0e0
0f0jb0h000
000af00c0c
b000000000
0000d00000
0a00000d00
0000i00000
h000000000

c000000000
00a0000kdk
ci0000000d
000f00b000
00000000b0
000j0a0000
000g000h00
00je00h000
00000fe000
000000gi00

00000kad0d
ka0000000g
00000000f0
0000j00000
000h000ib0
000e0i0j00
0000000b00
000e000c00
000hc00000
g00000f000

f000000000
b000000000
0f000000i0
000i0eg0h0
0000000jb0
0cde0000jc
000000ga00
00a0000d00
0000000000
00h0000000

0000a00000
000gj000i0
0000000j00
000k00000b
000000b000
0000hie0f0
0000d0f000
000000dc00
0g0000khc0
00a00000e0

000fi00000
0e00000000
0000000d00
00000ac000
0b0hc00000
000e000000
00ga000000
000d00000h
0bgf000i00
0000000000

0hc0000000
0d000000i0
000f0b00g0
000i0a00b0
0d00000000
0h00f00000
e0000a0000
00g0000000
0000000000
0e0000000c

e00000a0g0
di00000000
0000000000
h000c00e00
0g00000000
0ah0d00000
0000000i00
0000000c00
00fb000000
fb00000000