0000a000
0000f0bd
0000bd0f
000ec000
0000e000
0000c000
00000000
0a000000

acf00000
000000e0
00000000
d0db0000
00000000
b0000c00
00000000
ae0f0000

0a000000
000d00d0
00c00000
00000000
000af00b
000e000c
0f000000
000000eb

d0000000
000000fb
000g0000
0b0000fg
0000a00e
00e0000c
00ac000d
00000000

000000bc
000a0000
00000000
0a0f00d0
0b000c00
00000000
0f000000
0de0000e

a000000c
g000e000
d0000000
00000000
000000ce
0000g00a
0bf00000
0d0000fb

0000000d
e0000d00
00b0e000
0c0000a0
0b00c000
00000000
0a000000
00000000

00000feb
00000000
0e000000
00000000
0000d000
0bcga00c
0g00f00d
0000000a

00000000
0cb000d0
00e00000
e0000a00
c00b0f00
af000000
000000d0
00000000

000f0f0c
0b00b00e
00000000
0d000000
00e0a0c0
00000000
0000000d
a0000000

00000bg0
000000f0
0000b000
000d00f0
0d0e0000
000a00e0
000000a0
gc0c0000

0a0000d0
0000f0b0
0000c0c0
0b000000
0000000e
00d00e00
000000f0
0000a000

e000000a
00000000
000d0b00
000000fa
0000b000
00f000e0
d000c0c0
00000000

00d00000
0000c000
00000a00
000c0000
000000af
00fb0000
00000000
e0000edb

0b000000
00000000
0000dc00
000000a0
000de000
0000000e
00c00f0f
000b000a

b00000gb
0000e000
0000f000
00a0c000
e000d000
d0a00000
00fc00g0
00000000

c0000000
00000000
0g000000
eh00h000
f000a0e0
000dfgb0
0ad00000
0000b0c0

f000e000
c0000ada
f0c00d0b
i0000hi0
00hg0000
00g0e000
00000000
0000000b

0f0000e0
0h00a000
0a00e0h0
00fgc000
g0000dc0
000000d0
0b0000b0
00000000

00e0ai00
0d00g0g0
0000000i
b0000d0a
0000000f
00000c00
0ehc0000
000bhf00

00000hec
00000000
0b0000e0
000a0000
0d000f0c
000g0000
0a0000f0
0hgd0b00

0000e0c0
00f00ea0
00cb0000
0000a000
00000d00
00000000
0f0000b0
0d000000

b000000f
00cefg00
000000c0
00000000
0d000000
0000a000
0a00bde0
000g0000

0be00000
0ef00000
000f0a00
0d0g0000
00000ac0
00000cg0
00000000
bd000000

g00f0000
0d0ac000
0g000000
0e000000
000d0000
000b0000
b00000c0
e0a000f0

c0000000
df0e0000
00c00h00
0fb00000
00g0h000
a0d0gba0
00000000
e0000000

00000000
0g00000e
0000000f
0000bc00
00000000
00b00d00
00cgdf0a
000ea000

00000000
00ge000c
00000d00
0g0b00f0
0a000000
0b00a000
0d000000
000cf00e

000c0000
0b0000f0
0a0e0000
0d000b0c
00000000
00a00000
0000def0
00000000

0000ege0
0000a0f0
00b00000
00000gf0
00bc0000
00000d00
0cda0000
00000000