000000000
0afc00000
000fe0ec0
0000000g0
0b0ba0000
dg00000hi
0id000000
0h0000000
000000000

c000000h0
000000000
000000000
h00a0g0c0
000b000f0
0e00dg000
000000000
0ea00f000
00db00000

00c000000
c00000000
00000g000
df000000d
g000e0000
000000000
000be0000
0f000ab00
00000000a

de000000f
000e0000b
000000000
0000b00da
0000a000c
00000000g
0000f0000
00000000g
00000000c

b00000000
e000d00c0
g0000h000
000b00d00
000000000
000a00000
0000hc0fg
0ef0000a0
000000000

000000000
0d00di000
000000000
0000ecg00
0000f0a00
j00000000
g000ch0i0
e000f00a0
b000b0hj0

d000j0g00
00a0000i0
0b0f000c0
0a0000000
00e000000
00j000ic0
000fb0eh0
00000000g
d0000000h

c00000000
b0000g0gc
000f0000e
00000e000
0000000a0
00h000000
00d0h0da0
0000b0000
00000000f

ch0e00000
0d00000b0
000000gfh
000e0000c
00000bg00
000000000
00f000da0
0000a0000
000000000

000000000
000000000
00a000g00
000000000
000d00000
0f0000g00
0b0000a0b
0d000ec0e
00000f00c

d00000000
0fa0e0000
00000f000
i00000000
h0cdg0000
0i0c00000
00000a000
00b0000e0
h000gb000

000000000
0f00f0ea0
he0000000
00ga00000
00000000c
00b00bc00
00d000000
000000dh0
0000g0000

000000000
0000000b0
00d0000d0
00h0c0000
00g0he000
0000af0c0
0000g0000
0b0000fe0
000a00000

000000000
0h0ae0000
0i0000gh0
000ig0000
00000a00d
0000000b0
0fdbc0c00
e00000000
f00000000

f00000000
e000000e0
d000000c0
00a0a0000
d0cf00g00
000b00000
0b0000g00
000000000
000000000

0000a0ehb
000000d00
00c00c000
0ed000000
000000i00
0i0000b00
000ga00h0
0fg000000
00000000f

000000000
000ca0ad0
000000000
000e00000
00000dcfb
000000000
000000e00
f00000000
b00000000

00000000f
0000c0a00
000000i00
000i00000
000hbd000
00000g0g0
00000e000
0cah00b00
000000def

0000000b0
000gh0ch0
0000i0000
000ad0000
0g000bdf0
0e00000c0
00i000000
00000ea00
00000000f

0000da000
0c00000f0
0000a0000
eb0000b0h
0000h0000
000000gi0
00dc0e00f
00000000i
00000000g

000000000
0e0000000
000000g00
00b000c00
00f000000
00ac0d000
00000ea0g
00f0000db
000000000

0000eh00h
0000g0000
0gi000a0d
000000f00
0000i00b0
0cb00000a
00d0e0000
00c0000f0
000000000

000000000
0000ehg0f
0e00d0b00
000a0000g
c00000h00
00i000000
0000d0ia0
0000000f0
c000000b0

00e000000
0cgbh0000
000ad0000
000000000
000cf00h0
0000000db
00g00000e
000000fa0
000000000

fbd00000g
0000ha000
000000hc0
000000000
000g000e0
000000000
000ce0adb
000000000
f00000000

0000b0000
0000a00h0
0ad0000f0
00000b000
g000i0000
00h000f00
000000d00
000gc0e0e
c0000000i

0dhf00000
0000ae000
000000000
d00b0c000
000c00000
0g0000000
0000f0b00
0g0a00e00
0h0000000

000000000
0b00d0000
0000e0cd0
000000f00
000000000
a00000000
000000g00
0a0bfge00
0000c0000

f00000000
e000e00g0
0000000d0
0000000f0
0ch0hc0a0
00000a0b0
00d000000
000b00000
0g0000000

000000afb
0c0000000
h00a00000
000f00000
0b00000e0
0000g0000
000000d0d
000h00gei
c0000i000